10 10
L L L L L L L L L L
L L C C C C C C C L
T T T T C C T T C T
T T T T C C T T C T
T T T C C C C T C T
C C C C C C C C C T
C L L C C C C C C T
C L L C T T T C C T
C C C C T T T C C T
T T T C C C C C C T  