8 10
L L T A P C I T T T 
L T T T T C C C M T 
L L I S T C C T T T 
C L T T T C C T T L 
T L T T T L I M T C 
T T T T T C C T T T 
C C T C T C W T T T 
T T F T T I C T T C 