10 10
L L L L L L L L L L
L L C C C C C C C L
F T A T C C T P C M
T T T T C C T T C T
T T T W C C C T C T
C C C C C C C C C T
C L L C C C I C C T
C L L C T E T C C T
C C C C T O T C C T
T T T C C C C C C T  