8 10
L L T A T C C T T T 
L T T T T C C I M T 
L L C C T I C T T T 
S L T T T C C T T L 
T L T T T L C M T C 
T T T T T C C T T T 
S C T C T C C T T T 
T T T T T C C T T C 